"filename", "language", "JavaScript JSX", "JavaScript", "XML", "PostCSS", "comment", "blank", "total"
"c:\TaskFlow\src\App.css", "PostCSS", 0, 0, 0, -28, 0, -10, -38
"c:\TaskFlow\src\App.jsx", "JavaScript JSX", -100, 0, 0, 0, -3, -11, -114
"c:\TaskFlow\src\assets\react.svg", "XML", 0, 0, -8, 0, 0, 0, -8
"c:\TaskFlow\src\components\dashboard-components\BoardCard.jsx", "JavaScript JSX", -80, 0, 0, 0, 0, -9, -89
"c:\TaskFlow\src\components\dashboard-components\ColorSelector.jsx", "JavaScript JSX", -117, 0, 0, 0, 0, -6, -123
"c:\TaskFlow\src\components\dashboard-components\FilterForm.jsx", "JavaScript JSX", -189, 0, 0, 0, 0, -5, -194
"c:\TaskFlow\src\components\dashboard-components\PaginationControl.jsx", "JavaScript JSX", -50, 0, 0, 0, 0, -4, -54
"c:\TaskFlow\src\components\dashboard-components\SearchBar.jsx", "JavaScript JSX", -22, 0, 0, 0, 0, -2, -24
"c:\TaskFlow\src\components\dashboard-components\modals\BoardDetailsModal.jsx", "JavaScript JSX", -258, 0, 0, 0, -4, -12, -274
"c:\TaskFlow\src\components\dashboard-components\modals\CreateBoardModal.jsx", "JavaScript JSX", -158, 0, 0, 0, 0, -7, -165
"c:\TaskFlow\src\components\dashboard-components\modals\CreateTaskModal.jsx", "JavaScript JSX", -235, 0, 0, 0, 0, -10, -245
"c:\TaskFlow\src\components\dashboard-components\modals\DeleteBoardModal.jsx", "JavaScript JSX", -115, 0, 0, 0, 0, -8, -123
"c:\TaskFlow\src\components\home-components\About.jsx", "JavaScript JSX", -37, 0, 0, 0, 0, -2, -39
"c:\TaskFlow\src\components\home-components\Advantages.jsx", "JavaScript JSX", -36, 0, 0, 0, 0, -2, -38
"c:\TaskFlow\src\components\home-components\Contacts.jsx", "JavaScript JSX", -102, 0, 0, 0, 0, -5, -107
"c:\TaskFlow\src\components\home-components\FAQ.jsx", "JavaScript JSX", -52, 0, 0, 0, 0, -5, -57
"c:\TaskFlow\src\components\home-components\Features.jsx", "JavaScript JSX", -62, 0, 0, 0, 0, -2, -64
"c:\TaskFlow\src\components\home-components\Hero.jsx", "JavaScript JSX", -57, 0, 0, 0, 0, -2, -59
"c:\TaskFlow\src\components\home-components\HowItWorks.jsx", "JavaScript JSX", -27, 0, 0, 0, 0, -2, -29
"c:\TaskFlow\src\components\home-components\Partners.jsx", "JavaScript JSX", -46, 0, 0, 0, 0, -1, -47
"c:\TaskFlow\src\components\home-components\Reviewers.jsx", "JavaScript JSX", -27, 0, 0, 0, 0, -2, -29
"c:\TaskFlow\src\components\home-components\Security.jsx", "JavaScript JSX", -59, 0, 0, 0, 0, -6, -65
"c:\TaskFlow\src\components\home-components\Slider.jsx", "JavaScript JSX", -45, 0, 0, 0, 0, -2, -47
"c:\TaskFlow\src\components\main-components\AnimatedError.jsx", "JavaScript JSX", -39, 0, 0, 0, 0, -4, -43
"c:\TaskFlow\src\components\main-components\BackToTop.jsx", "JavaScript JSX", -30, 0, 0, 0, 0, -5, -35
"c:\TaskFlow\src\components\main-components\ErrorPage.jsx", "JavaScript JSX", -25, 0, 0, 0, 0, -6, -31
"c:\TaskFlow\src\components\main-components\Footer.jsx", "JavaScript JSX", -83, 0, 0, 0, 0, -3, -86
"c:\TaskFlow\src\components\main-components\Header.jsx", "JavaScript JSX", -111, 0, 0, 0, 0, -8, -119
"c:\TaskFlow\src\components\main-components\Loader.jsx", "JavaScript JSX", -17, 0, 0, 0, 0, -4, -21
"c:\TaskFlow\src\components\main-components\Page.jsx", "JavaScript JSX", -16, 0, 0, 0, 0, -2, -18
"c:\TaskFlow\src\components\main-components\Separator.jsx", "JavaScript JSX", -19, 0, 0, 0, 0, -1, -20
"c:\TaskFlow\src\components\main-components\checkbox\FormikCheckbox.jsx", "JavaScript JSX", -37, 0, 0, 0, 0, -4, -41
"c:\TaskFlow\src\components\main-components\checkbox\Simple–°heckBox.jsx", "JavaScript JSX", -30, 0, 0, 0, 0, -2, -32
"c:\TaskFlow\src\components\main-components\route-auth\PrivateRoute.jsx", "JavaScript JSX", -10, 0, 0, 0, 0, -4, -14
"c:\TaskFlow\src\components\main-components\route-auth\PublicRoute.jsx", "JavaScript JSX", -10, 0, 0, 0, 0, -4, -14
"c:\TaskFlow\src\components\main-components\user\DeleteUserModal.jsx", "JavaScript JSX", -181, 0, 0, 0, 0, -6, -187
"c:\TaskFlow\src\components\main-components\user\LogoutUserModal.jsx", "JavaScript JSX", -83, 0, 0, 0, 0, -4, -87
"c:\TaskFlow\src\components\main-components\user\UpdateUserModal.jsx", "JavaScript JSX", -239, 0, 0, 0, -27, -13, -279
"c:\TaskFlow\src\components\register-components\RegisterFirstStep.jsx", "JavaScript JSX", -197, 0, 0, 0, 0, -10, -207
"c:\TaskFlow\src\components\register-components\RegisterSecondStep.jsx", "JavaScript JSX", -79, 0, 0, 0, 0, -4, -83
"c:\TaskFlow\src\components\register-components\RegisterThirdStep.jsx", "JavaScript JSX", -25, 0, 0, 0, 0, -2, -27
"c:\TaskFlow\src\components\task-components\TaskCard.jsx", "JavaScript JSX", -52, 0, 0, 0, -7, -2, -61
"c:\TaskFlow\src\config\blockedPublicPaths.jsx", "JavaScript JSX", -1, 0, 0, 0, 0, -1, -2
"c:\TaskFlow\src\config\routes.js", "JavaScript", 0, -76, 0, 0, 0, -12, -88
"c:\TaskFlow\src\data\advantages.jsx", "JavaScript JSX", -52, 0, 0, 0, 0, -2, -54
"c:\TaskFlow\src\data\faqs.jsx", "JavaScript JSX", -64, 0, 0, 0, 0, -1, -65
"c:\TaskFlow\src\data\filterAndSortData.jsx", "JavaScript JSX", -31, 0, 0, 0, 0, -6, -37
"c:\TaskFlow\src\data\legalLinks.jsx", "JavaScript JSX", -9, 0, 0, 0, 0, -1, -10
"c:\TaskFlow\src\data\logos.jsx", "JavaScript JSX", -107, 0, 0, 0, 0, -1, -108
"c:\TaskFlow\src\data\navLinks.jsx", "JavaScript JSX", -12, 0, 0, 0, 0, -1, -13
"c:\TaskFlow\src\data\privacy.jsx", "JavaScript JSX", -67, 0, 0, 0, 0, -1, -68
"c:\TaskFlow\src\data\reviewers.jsx", "JavaScript JSX", -98, 0, 0, 0, 0, -2, -100
"c:\TaskFlow\src\data\security.jsx", "JavaScript JSX", -27, 0, 0, 0, 0, -1, -28
"c:\TaskFlow\src\data\taskOptions.jsx", "JavaScript JSX", -23, 0, 0, 0, 0, -3, -26
"c:\TaskFlow\src\data\team.jsx", "JavaScript JSX", -39, 0, 0, 0, 0, -3, -42
"c:\TaskFlow\src\data\terms.jsx", "JavaScript JSX", -53, 0, 0, 0, 0, -2, -55
"c:\TaskFlow\src\data\work.jsx", "JavaScript JSX", -22, 0, 0, 0, 0, -1, -23
"c:\TaskFlow\src\hooks\useAuthTokenRefresh.jsx", "JavaScript JSX", -18, 0, 0, 0, 0, -5, -23
"c:\TaskFlow\src\hooks\useLockScroll.jsx", "JavaScript JSX", -21, 0, 0, 0, 0, -3, -24
"c:\TaskFlow\src\hooks\useMediaQuery.jsx", "JavaScript JSX", -33, 0, 0, 0, 0, -8, -41
"c:\TaskFlow\src\hooks\useResponsive.jsx", "JavaScript JSX", -17, 0, 0, 0, 0, -5, -22
"c:\TaskFlow\src\hooks\useSocket.jsx", "JavaScript JSX", -24, 0, 0, 0, 0, -6, -30
"c:\TaskFlow\src\index.css", "PostCSS", 0, 0, 0, -191, -6, -38, -235
"c:\TaskFlow\src\main.jsx", "JavaScript JSX", -12, 0, 0, 0, 0, -2, -14
"c:\TaskFlow\src\pages\DashboardPage.jsx", "JavaScript JSX", -240, 0, 0, 0, 0, -25, -265
"c:\TaskFlow\src\pages\HomePage.jsx", "JavaScript JSX", -59, 0, 0, 0, 0, -4, -63
"c:\TaskFlow\src\pages\LoginPage.jsx", "JavaScript JSX", -161, 0, 0, 0, 0, -8, -169
"c:\TaskFlow\src\pages\PrivacyPage.jsx", "JavaScript JSX", -24, 0, 0, 0, 0, -5, -29
"c:\TaskFlow\src\pages\RegisterPage.jsx", "JavaScript JSX", -43, 0, 0, 0, 0, -5, -48
"c:\TaskFlow\src\pages\ResetPasswordPage.jsx", "JavaScript JSX", -197, 0, 0, 0, 0, -13, -210
"c:\TaskFlow\src\pages\SettingsPage.jsx", "JavaScript JSX", -67, 0, 0, 0, 0, -6, -73
"c:\TaskFlow\src\pages\TermsPage.jsx", "JavaScript JSX", -24, 0, 0, 0, 0, -6, -30
"c:\TaskFlow\src\pages\errors\Error400.jsx", "JavaScript JSX", -13, 0, 0, 0, 0, -3, -16
"c:\TaskFlow\src\pages\errors\Error401.jsx", "JavaScript JSX", -13, 0, 0, 0, 0, -3, -16
"c:\TaskFlow\src\pages\errors\Error403.jsx", "JavaScript JSX", -13, 0, 0, 0, 0, -3, -16
"c:\TaskFlow\src\pages\errors\Error404.jsx", "JavaScript JSX", -13, 0, 0, 0, 0, -2, -15
"c:\TaskFlow\src\pages\errors\Error500.jsx", "JavaScript JSX", -13, 0, 0, 0, 0, -3, -16
"c:\TaskFlow\src\store\authStore.js", "JavaScript", 0, -6, 0, 0, 0, -4, -10
"c:\TaskFlow\src\store\boardStore.js", "JavaScript", 0, -150, 0, 0, 0, -24, -174
"c:\TaskFlow\src\store\modalsStore.js", "JavaScript", 0, -29, 0, 0, 0, -10, -39
"c:\TaskFlow\src\store\registerStore.js", "JavaScript", 0, -8, 0, 0, 0, -2, -10
"c:\TaskFlow\src\store\taskStore.js", "JavaScript", 0, -229, 0, 0, 0, -18, -247
"c:\TaskFlow\src\store\userStore.js", "JavaScript", 0, -7, 0, 0, 0, -5, -12
"c:\TaskFlow\src\utils\color\normalizeColor.js", "JavaScript", 0, -3, 0, 0, 0, -1, -4
"c:\TaskFlow\src\utils\date\dateFormatter.js", "JavaScript", 0, -9, 0, 0, 0, -1, -10
"c:\TaskFlow\src\utils\filters\boardFilters.js", "JavaScript", 0, -27, 0, 0, 0, -5, -32
"c:\TaskFlow\src\utils\filters\boardSorts.js", "JavaScript", 0, -36, 0, 0, 0, -5, -41
"c:\TaskFlow\src\utils\responsesHandler\apiResponsesHandler.js", "JavaScript", 0, -66, 0, 0, 0, -11, -77
"c:\TaskFlow\src\utils\toast\showToast.js", "JavaScript", 0, -15, 0, 0, 0, -2, -17
"c:\TaskFlow\src\validators\confirmCodeSchema.js", "JavaScript", 0, -6, 0, 0, 0, -2, -8
"c:\TaskFlow\src\validators\emailSchema.js", "JavaScript", 0, -4, 0, 0, 0, -2, -6
"c:\TaskFlow\src\validators\loginSchema.js", "JavaScript", 0, -7, 0, 0, 0, -3, -10
"c:\TaskFlow\src\validators\passwordResetSchema.js", "JavaScript", 0, -38, 0, 0, 0, -6, -44
"c:\TaskFlow\src\validators\registerSchema.js", "JavaScript", 0, -49, 0, 0, 0, -8, -57
"c:\TaskFlow\src\validators\updateSchema.js", "JavaScript", 0, -12, 0, 0, 0, -2, -14
"Total", "-", -4767, -777, -8, -219, -47, -505, -6323